WWWWWWWWWWWWWWWWWWWW
WSSSSSSSSSSSSSSSSSSW
WSSSSSSSSSSSSSSSSSSW
WSSSSSSSSSSSSSSSSSSW
WSSSSSSSSSSSSSSSSSSW
WSSSSSSSSSSSSSSSSSSW
WSSSSSSSSSSSSSSSSSSW
WSSSSSSSSSSSSSSSSSSW
WSSSSSSSSSSSSSSSSSSW
WSSSSSSSSSSSSSSSSSSW
WSSSSSSSSSSSSSSSSSSW
WSSSSSSSSSSSSSSSSSSW
WSSSSSSSSSSSSSSSSSSW
WSSSSSSSSSSSSSSSSSSW
WSSSSSSSSSSSSSSSSSSW
WSSSSSSSSSSSSSSSSSSW
WSSSSSSSSSSSSSSSSSSW
WSSSSSSSSSSSSSSSSSSW
WSSSSSSSSSSSSSSSSSSW
WWWWWWWWWWWWWWWWWWWW